Anderlecht = Anderlecht
Antwerp = Royal Antwerp 
St.Truiden = St. Truidense
Eupen = KAS Eupen
RWDM = Racing White Daring Molenbeek
Gent = KAA Gent
KVMechelen = KV Mechelen
CercleBrugge = Cercle Brugge
Genk = Genk
Westerlo = KVC Westerlo
Charleroi = Royal Charleroi
RoyaleUnion = Union Saint-Gilloise
ClubBrugge = Club Brugge
Leuven = Oud-Heverlee Leuven
St.Liege = Standard Liege
Kortrijk = Kortrijk
RBLeipzig = RB Leipzig
WerderBremen = Werder Bremen
Freiburg = Freiburg
EintrachtFrankfurt = Eintracht Frankfurt
BayerLeverkusen = Bayer Leverkusen
UnionBerlin = Union Berlin
Bochum = VfL Bochum
FCKoln = 1. FC Cologne
Augsburg = FC Augsburg
Hoffenheim = TSG Hoffenheim
BayernMunich = Bayern Munich
Heidenheim = 1. FC Heidenheim
Darmstadt = Darmstadt
Mainz = FSV Mainz
Stuttgart = VfB Stuttgart
Dortmund = Borussia Dortmund
B.Monchengladbach = Monchengladbach
Wolfsburg = VfL Wolfsburg
GreutherFurth = Greuther Furth
Dusseldorf = Fortuna Dusseldorf
Magdeburg = 1. FC Magdeburg
HansaRostock = Hansa Rostock
Wehen = SV Wehen Wiesbaden
Kaiserslautern = 1 FC Kaiserslautern
HerthaBerlin = Hertha Berlin
KarlsruherSC = Karlsruher SC
Braunschweig = Eintracht Braunschweig
VfLOsnabruck = VfL 1899 Osnabruck
HolsteinKiel = Holstein Kiel
HamburgerSV = Hamburger SV
Paderborn = SC Paderborn 07
Nurnberg = 1 FC Nuremberg
Schalke = Schalke 04
St.Pauli = FC St. Pauli
Hannover = Hannover 96
Elversberg = SV 07 Elversberg
Burnley = Burnley FC
ManchesterCity = Manchester City
Arsenal = Arsenal
Nottingham = Nottingham Forest
Bournemouth = AFC Bournemouth
WestHam = West Ham United
Brighton = Brighton
Luton = Luton Town
Everton = Everton FC
Fulham = Fulham FC
SheffieldUtd = Sheffield United
CrystalPalace = Crystal Palace
Newcastle = Newcastle United
AstonVilla = Aston Villa
Brentford = Brentford FC
Tottenham = Tottenham
Chelsea = Chelsea
Liverpool = Liverpool FC
ManchesterUtd = Man Utd
Wolves = Wolverhampton Wanderers
Atl.Madrid = Atletico Madrid
Villarreal = Villarreal
Sevilla = Sevilla FC
Betis = Real Betis Seville
Barcelona = FC Barcelona
Alaves = Alaves
RealMadrid = Real Madrid
Valencia = Valencia CF
GranadaCF = Granada
Getafe = Getafe CF
Osasuna = CA Osasuna
LasPalmas = UD Las Palmas
Almeria = UD Almeria
RealSociedad = Real Sociedad
RayoVallecano = Rayo Vallecano
AthBilbao = Athletic Bilbao
Girona = Girona FC
CeltaVigo = RC Celta de Vigo
CadizCF = Cadiz
Mallorca = RCD Mallorca
Lens = RC Lens
Marseille = Olympique Marseille
Rennes = Stade Rennes
Lyon = Olympique Lyon
Clermont = Clermont Foot
Lorient = Lorient
Lille = Lille OSC
Toulouse = Toulouse FC
Metz = FC Metz
Nantes = FC Nantes
LeHavre = Le Havre AC
Monaco = Monaco
Reims = Stade Reims
PSG = PSG
Montpellier = Montpellier HSC
Nice = OGC Nice
Brest = Stade Brest 29
Strasbourg = Strasbourg Alsace
Bari = SSC Bari
Cosenza = Cosenza Calcio
Pisa = Pisa SC
Ascoli = Ascoli Calcio 1898
Sampdoria = Sampdoria Genoa
FeralpiSalo = Feralpisalo
Sudtirol = FC Sudtirol Bolzano
Reggiana = Reggiana 1919
Catanzaro = US Catanzaro
Brescia = Brescia Calcio
Cittadella = AS Cittadella
Spezia = Spezia Calcio
Como = Como 1907
Palermo = Palermo FC
Cremonese = US Cremonese
Modena = Modena FC
Parma = Parma Calcio
Ternana = Ternana Calcio
Venezia = Venezia FC
Lecco = Calcio Lecco 1912
Inter = Inter Milan
Frosinone = Frosinone Calcio
Lazio = Lazio Rome
ASRoma = AS Roma
Fiorentina = Fiorentina
Bologna = Bologna FC
Udinese = Udinese Calcio
Atalanta = Atalanta BC
Napoli = Napoli
Empoli = Empoli
Monza = AC Monza
Torino = Torino FC
Juventus = Juventus Turin
Cagliari = Cagliari
Lecce = US Lecce
ACMilan = AC Milan
Genoa = Genoa CFC
Verona = Hellas Verona
Sassuolo = Sassuolo
Salernitana = US Salernitana